F 31,99,112
C 17,16,38

NO textures/north.xpm
SO textures/south.xpm
WE textures/west.xpm
EA textures/east.xpm


111111111111111  11111111111111111111111111111111111111
100000000000001  1000000000000000000000000000000000001
111000000000001  100000000000000000000000000000000011
  1000000000001  1000000000000000000000000000000000011
  10000000000011110000000000000000000000000000000000101
  1000000000000000000000000000000000000000000000000011
11100000000000011100011110001111000111000000000000001
10000000000000001000000100000010000010000000000000011
1000000000000000100011110001111000001000000000000001
1000000000000000100000010000001000001000000000000001
1000000000000011110011110001111000001000000000000001
1000000000000000000000000000000000000000000000000001
10000000000000000000N0000000000000000000000000000001
1111111111111111111111111111111111111111111111111111