F 31,99,112
C 17,16,38

NO textures/north.xpm
SO textures/south.xpm
WE textures/west.xpm
EA textures/east.xpm


1111111111111111111111111111111111111111111111111111
1000000000000000000000000000000000000000000000000001
1000000000000000000000000000000000000000000000000001
  00000000000000000000000000000000000000000000000001
  00000000000000000000000000000000000000000000000001
  00000000000000000000000000000000000000000000000001
  00000000000011100011110001111000111000000000000001
1000000000000000100000010000001000001000000000000001
1000000000000000100011110001111000001000000000000001
1000000000000000100000010000001000001000000000000001
1000000000000011110011110001111000001000000000000001
1000000000000000000000000000000000000000000000000001
10000000000000000000N0000000000000000000000000000001
11111111111111                   1111111111111111111

