
NO textures/north.xpm


SO textures/south.xpm


WE textures/west.xpm







EA textures/east.xpm

F 164,169,20
C 153,204,255          ,0

                             1111111111111111            
111111111111111111111111111111000000000000001
101000001N00000000001111111111000000000000001
1010101010111111100011111111110000000000000000001
100010100010000010001111111111000000000000001
111110101111101011101111111111000000000000001
100000101000101000001111111111000000000000001
101111101011101111111111111111000000000000001
101000001010100000101111111111000000000000001
101011111010111110101111111111000000000000001
101010001010100010101111111111000000000000001
101110101010101010101111111111000000000000001
100000101010001010001111111111000000000000001
111111101011111011101111111111000000000000001
100000101000100010001111111111000000000000001
101110101110101110111111111111000000000000001
101000100000100010101111111111000000000000001
101011111111111010101111111111000000000000001
100010000000000010001111111111000000000000001
101010111011111111101111111111000000000000001
111000001000000000001111111111000000000000001
111111111111111111111111111111111111111111111