F 0,135,206
C 99,99,99


NO textures/north.xpm

SO textures/south.xpm

WE textures/west.xpm

EA textures/east.xpm

1111111111111111
1000000000000001
1000000000000001
1000000000000001
1111111111111111
1111111111111111
1111111111111111
1000000000000001
100000N000000001
1000000000000001
1111111111111111